p___m____p
___t______
m___tm___m
_____t____
p___m____p