p________p
__________
__________
__________
p________m