p________p
__________
____oo____
__________
p________m